1111111111111
10010C00000C1
100V011111V01
1P0011E000001
1111111111111